Group_1
Зеленая плесень - Green Mold
Болотный камень - Swamp Stone

Group_2
Корень-вонючка - Stinky Root
Срачник - Crappite
Остатки медной проволки - Pieces of Copper Wire

Group_3
Росток чернобыльской ромашки - Sprig of Chernobyl Chamomile
Рассольник - Pickle
Остатки радиопередатчика - Remains of a Radio Transmitter
Фрагмент данных "Альфа" - Alpha Data Fragment

Group_4
Северный мох - Northern Moss
Дурман-камень - Dopestone
Остатки аккумуляторов - Remains of Batteries
Фрагмент данных "Бета" - Beta Data Fragment

Group_5
Рыжий папоротник - Red Fern
Вещество 07270 - Substance 07270
Остатки пси-маячка - Remains of a Psy-Tracker
Фрагмент данных "Гамма" - Gamma Data Fragment
Квантовая батарея - Quantum Battery
Аномальная сыворотка - Anomalous Serum

Group_6
Горьколистник - Bitterleaf
Лимб - Limbo
Фрагмент данных "Лямбда" - Lambda Data Fragment
Аномальная батарея - Anomalous Battery
Лимбоплазма - Limboplasma

Обменные монеты - Trade Coins
Коробки сезона открыто - Season box
Арсенал - Arsenal Points

Ближний бой - Melee Weapons